/interfaces-state/interface[name=*]/admin-status	(type=enumeration)
/interfaces-state/interface[name=*]/higher-layer-if	(type=interface-state-ref)
/interfaces-state/interface[name=*]/if-index	(type=int32)
/interfaces-state/interface[name=*]/last-change	(type=date-and-time)
/interfaces-state/interface[name=*]/lower-layer-if	(type=interface-state-ref)
/interfaces-state/interface[name=*]/name	(type=string)
/interfaces-state/interface[name=*]/oper-status	(type=enumeration)
/interfaces-state/interface[name=*]/phys-address	(type=phys-address)
/interfaces-state/interface[name=*]/speed	(type=gauge64)
/interfaces-state/interface[name=*]/statistics/discontinuity-time	(type=date-and-time)
/interfaces-state/interface[name=*]/statistics/in-broadcast-pkts	(type=counter64)
/interfaces-state/interface[name=*]/statistics/in-discards	(type=counter32)
/interfaces-state/interface[name=*]/statistics/in-errors	(type=counter32)
/interfaces-state/interface[name=*]/statistics/in-multicast-pkts	(type=counter64)
/interfaces-state/interface[name=*]/statistics/in-octets	(type=counter64)
/interfaces-state/interface[name=*]/statistics/in-unicast-pkts	(type=counter64)
/interfaces-state/interface[name=*]/statistics/in-unknown-protos	(type=counter32)
/interfaces-state/interface[name=*]/statistics/out-broadcast-pkts	(type=counter64)
/interfaces-state/interface[name=*]/statistics/out-discards	(type=counter32)
/interfaces-state/interface[name=*]/statistics/out-errors	(type=counter32)
/interfaces-state/interface[name=*]/statistics/out-multicast-pkts	(type=counter64)
/interfaces-state/interface[name=*]/statistics/out-octets	(type=counter64)
/interfaces-state/interface[name=*]/statistics/out-unicast-pkts	(type=counter64)
/interfaces-state/interface[name=*]/type	(type=identityref)
/interfaces/interface[name=*]/aggregation/config/lag-type	(type=aggregation-type)
/interfaces/interface[name=*]/aggregation/config/min-links	(type=uint16)
/interfaces/interface[name=*]/aggregation/state/lag-speed	(type=uint32)
/interfaces/interface[name=*]/aggregation/state/lag-type	(type=aggregation-type)
/interfaces/interface[name=*]/aggregation/state/member	(type=base-interface-ref)
/interfaces/interface[name=*]/aggregation/state/min-links	(type=uint16)
/interfaces/interface[name=*]/aggregation/switched-vlan/config/access-vlan	(type=vlan-id)
/interfaces/interface[name=*]/aggregation/switched-vlan/config/interface-mode	(type=vlan-mode-type)
/interfaces/interface[name=*]/aggregation/switched-vlan/config/native-vlan	(type=vlan-id)
/interfaces/interface[name=*]/aggregation/switched-vlan/config/trunk-vlans	(type=union)
/interfaces/interface[name=*]/aggregation/switched-vlan/state/access-vlan	(type=vlan-id)
/interfaces/interface[name=*]/aggregation/switched-vlan/state/interface-mode	(type=vlan-mode-type)
/interfaces/interface[name=*]/aggregation/switched-vlan/state/native-vlan	(type=vlan-id)
/interfaces/interface[name=*]/aggregation/switched-vlan/state/trunk-vlans	(type=union)
/interfaces/interface[name=*]/config/description	(type=string)
/interfaces/interface[name=*]/config/enabled	(type=boolean)
/interfaces/interface[name=*]/config/loopback-mode	(type=boolean)
/interfaces/interface[name=*]/config/mtu	(type=uint16)
/interfaces/interface[name=*]/config/name	(type=string)
/interfaces/interface[name=*]/config/tpid	(type=identityref)
/interfaces/interface[name=*]/description	(type=string)
/interfaces/interface[name=*]/enabled	(type=boolean)
/interfaces/interface[name=*]/ethernet/config/aggregate-id	(type=leafref)
/interfaces/interface[name=*]/ethernet/config/auto-negotiate	(type=boolean)
/interfaces/interface[name=*]/ethernet/config/duplex-mode	(type=enumeration)
/interfaces/interface[name=*]/ethernet/config/enable-flow-control	(type=boolean)
/interfaces/interface[name=*]/ethernet/config/mac-address	(type=mac-address)
/interfaces/interface[name=*]/ethernet/config/port-speed	(type=identityref)
/interfaces/interface[name=*]/ethernet/config/standalone-link-training	(type=boolean)
/interfaces/interface[name=*]/ethernet/state/aggregate-id	(type=leafref)
/interfaces/interface[name=*]/ethernet/state/auto-negotiate	(type=boolean)
/interfaces/interface[name=*]/ethernet/state/counters/in-8021q-frames	(type=counter64)
/interfaces/interface[name=*]/ethernet/state/counters/in-block-errors	(type=counter64)
/interfaces/interface[name=*]/ethernet/state/counters/in-carrier-errors	(type=counter64)
/interfaces/interface[name=*]/ethernet/state/counters/in-crc-errors	(type=counter64)
/interfaces/interface[name=*]/ethernet/state/counters/in-fragment-frames	(type=counter64)
/interfaces/interface[name=*]/ethernet/state/counters/in-interrupted-tx	(type=counter64)
/interfaces/interface[name=*]/ethernet/state/counters/in-jabber-frames	(type=counter64)
/interfaces/interface[name=*]/ethernet/state/counters/in-late-collision	(type=counter64)
/interfaces/interface[name=*]/ethernet/state/counters/in-mac-control-frames	(type=counter64)
/interfaces/interface[name=*]/ethernet/state/counters/in-mac-errors-rx	(type=counter64)
/interfaces/interface[name=*]/ethernet/state/counters/in-mac-pause-frames	(type=counter64)
/interfaces/interface[name=*]/ethernet/state/counters/in-maxsize-exceeded	(type=counter64)
/interfaces/interface[name=*]/ethernet/state/counters/in-oversize-frames	(type=counter64)
/interfaces/interface[name=*]/ethernet/state/counters/in-single-collision	(type=counter64)
/interfaces/interface[name=*]/ethernet/state/counters/in-symbol-error	(type=counter64)
/interfaces/interface[name=*]/ethernet/state/counters/in-undersize-frames	(type=counter64)
/interfaces/interface[name=*]/ethernet/state/counters/out-8021q-frames	(type=counter64)
/interfaces/interface[name=*]/ethernet/state/counters/out-mac-control-frames	(type=counter64)
/interfaces/interface[name=*]/ethernet/state/counters/out-mac-errors-tx	(type=counter64)
/interfaces/interface[name=*]/ethernet/state/counters/out-mac-pause-frames	(type=counter64)
/interfaces/interface[name=*]/ethernet/state/duplex-mode	(type=enumeration)
/interfaces/interface[name=*]/ethernet/state/enable-flow-control	(type=boolean)
/interfaces/interface[name=*]/ethernet/state/hw-mac-address	(type=mac-address)
/interfaces/interface[name=*]/ethernet/state/mac-address	(type=mac-address)
/interfaces/interface[name=*]/ethernet/state/negotiated-duplex-mode	(type=enumeration)
/interfaces/interface[name=*]/ethernet/state/negotiated-port-speed	(type=identityref)
/interfaces/interface[name=*]/ethernet/state/port-speed	(type=identityref)
/interfaces/interface[name=*]/ethernet/state/standalone-link-training	(type=boolean)
/interfaces/interface[name=*]/ethernet/switched-vlan/config/access-vlan	(type=vlan-id)
/interfaces/interface[name=*]/ethernet/switched-vlan/config/interface-mode	(type=vlan-mode-type)
/interfaces/interface[name=*]/ethernet/switched-vlan/config/native-vlan	(type=vlan-id)
/interfaces/interface[name=*]/ethernet/switched-vlan/config/trunk-vlans	(type=union)
/interfaces/interface[name=*]/ethernet/switched-vlan/state/access-vlan	(type=vlan-id)
/interfaces/interface[name=*]/ethernet/switched-vlan/state/interface-mode	(type=vlan-mode-type)
/interfaces/interface[name=*]/ethernet/switched-vlan/state/native-vlan	(type=vlan-id)
/interfaces/interface[name=*]/ethernet/switched-vlan/state/trunk-vlans	(type=union)
/interfaces/interface[name=*]/hold-time/config/down	(type=uint32)
/interfaces/interface[name=*]/hold-time/config/up	(type=uint32)
/interfaces/interface[name=*]/hold-time/state/down	(type=uint32)
/interfaces/interface[name=*]/hold-time/state/up	(type=uint32)
/interfaces/interface[name=*]/link-up-down-trap-enable	(type=enumeration)
/interfaces/interface[name=*]/name	(type=leafref)
/interfaces/interface[name=*]/name	(type=string)
/interfaces/interface[name=*]/routed-vlan/config/vlan	(type=union)
/interfaces/interface[name=*]/routed-vlan/ipv4/addresses/address[ip=*]/config/ip	(type=ipv4-address)
/interfaces/interface[name=*]/routed-vlan/ipv4/addresses/address[ip=*]/config/prefix-length	(type=uint8)
/interfaces/interface[name=*]/routed-vlan/ipv4/addresses/address[ip=*]/ip	(type=leafref)
/interfaces/interface[name=*]/routed-vlan/ipv4/addresses/address[ip=*]/state/ip	(type=ipv4-address)
/interfaces/interface[name=*]/routed-vlan/ipv4/addresses/address[ip=*]/state/origin	(type=ip-address-origin)
/interfaces/interface[name=*]/routed-vlan/ipv4/addresses/address[ip=*]/state/prefix-length	(type=uint8)
/interfaces/interface[name=*]/routed-vlan/ipv4/addresses/address[ip=*]/vrrp/vrrp-group[virtual-router-id=*]/config/accept-mode	(type=boolean)
/interfaces/interface[name=*]/routed-vlan/ipv4/addresses/address[ip=*]/vrrp/vrrp-group[virtual-router-id=*]/config/advertisement-interval	(type=uint16)
/interfaces/interface[name=*]/routed-vlan/ipv4/addresses/address[ip=*]/vrrp/vrrp-group[virtual-router-id=*]/config/preempt	(type=boolean)
/interfaces/interface[name=*]/routed-vlan/ipv4/addresses/address[ip=*]/vrrp/vrrp-group[virtual-router-id=*]/config/preempt-delay	(type=uint16)
/interfaces/interface[name=*]/routed-vlan/ipv4/addresses/address[ip=*]/vrrp/vrrp-group[virtual-router-id=*]/config/priority	(type=uint8)
/interfaces/interface[name=*]/routed-vlan/ipv4/addresses/address[ip=*]/vrrp/vrrp-group[virtual-router-id=*]/config/virtual-address	(type=ip-address)
/interfaces/interface[name=*]/routed-vlan/ipv4/addresses/address[ip=*]/vrrp/vrrp-group[virtual-router-id=*]/config/virtual-router-id	(type=uint8)
/interfaces/interface[name=*]/routed-vlan/ipv4/addresses/address[ip=*]/vrrp/vrrp-group[virtual-router-id=*]/interface-tracking/config/priority-decrement	(type=uint8)
/interfaces/interface[name=*]/routed-vlan/ipv4/addresses/address[ip=*]/vrrp/vrrp-group[virtual-router-id=*]/interface-tracking/config/track-interface	(type=leafref)
/interfaces/interface[name=*]/routed-vlan/ipv4/addresses/address[ip=*]/vrrp/vrrp-group[virtual-router-id=*]/interface-tracking/state/priority-decrement	(type=uint8)
/interfaces/interface[name=*]/routed-vlan/ipv4/addresses/address[ip=*]/vrrp/vrrp-group[virtual-router-id=*]/interface-tracking/state/track-interface	(type=leafref)
/interfaces/interface[name=*]/routed-vlan/ipv4/addresses/address[ip=*]/vrrp/vrrp-group[virtual-router-id=*]/state/accept-mode	(type=boolean)
/interfaces/interface[name=*]/routed-vlan/ipv4/addresses/address[ip=*]/vrrp/vrrp-group[virtual-router-id=*]/state/advertisement-interval	(type=uint16)
/interfaces/interface[name=*]/routed-vlan/ipv4/addresses/address[ip=*]/vrrp/vrrp-group[virtual-router-id=*]/state/current-priority	(type=uint8)
/interfaces/interface[name=*]/routed-vlan/ipv4/addresses/address[ip=*]/vrrp/vrrp-group[virtual-router-id=*]/state/preempt	(type=boolean)
/interfaces/interface[name=*]/routed-vlan/ipv4/addresses/address[ip=*]/vrrp/vrrp-group[virtual-router-id=*]/state/preempt-delay	(type=uint16)
/interfaces/interface[name=*]/routed-vlan/ipv4/addresses/address[ip=*]/vrrp/vrrp-group[virtual-router-id=*]/state/priority	(type=uint8)
/interfaces/interface[name=*]/routed-vlan/ipv4/addresses/address[ip=*]/vrrp/vrrp-group[virtual-router-id=*]/state/virtual-address	(type=ip-address)
/interfaces/interface[name=*]/routed-vlan/ipv4/addresses/address[ip=*]/vrrp/vrrp-group[virtual-router-id=*]/state/virtual-router-id	(type=uint8)
/interfaces/interface[name=*]/routed-vlan/ipv4/addresses/address[ip=*]/vrrp/vrrp-group[virtual-router-id=*]/virtual-router-id	(type=leafref)
/interfaces/interface[name=*]/routed-vlan/ipv4/config/dhcp-client	(type=boolean)
/interfaces/interface[name=*]/routed-vlan/ipv4/config/enabled	(type=boolean)
/interfaces/interface[name=*]/routed-vlan/ipv4/config/mtu	(type=uint16)
/interfaces/interface[name=*]/routed-vlan/ipv4/neighbors/neighbor[ip=*]/config/ip	(type=ipv4-address)
/interfaces/interface[name=*]/routed-vlan/ipv4/neighbors/neighbor[ip=*]/config/link-layer-address	(type=phys-address)
/interfaces/interface[name=*]/routed-vlan/ipv4/neighbors/neighbor[ip=*]/ip	(type=leafref)
/interfaces/interface[name=*]/routed-vlan/ipv4/neighbors/neighbor[ip=*]/state/ip	(type=ipv4-address)
/interfaces/interface[name=*]/routed-vlan/ipv4/neighbors/neighbor[ip=*]/state/link-layer-address	(type=phys-address)
/interfaces/interface[name=*]/routed-vlan/ipv4/neighbors/neighbor[ip=*]/state/origin	(type=neighbor-origin)
/interfaces/interface[name=*]/routed-vlan/ipv4/proxy-arp/config/mode	(type=enumeration)
/interfaces/interface[name=*]/routed-vlan/ipv4/proxy-arp/state/mode	(type=enumeration)
/interfaces/interface[name=*]/routed-vlan/ipv4/state/counters/in-discarded-pkts	(type=counter64)
/interfaces/interface[name=*]/routed-vlan/ipv4/state/counters/in-error-pkts	(type=counter64)
/interfaces/interface[name=*]/routed-vlan/ipv4/state/counters/in-forwarded-octets	(type=counter64)
/interfaces/interface[name=*]/routed-vlan/ipv4/state/counters/in-forwarded-pkts	(type=counter64)
/interfaces/interface[name=*]/routed-vlan/ipv4/state/counters/in-octets	(type=counter64)
/interfaces/interface[name=*]/routed-vlan/ipv4/state/counters/in-pkts	(type=counter64)
/interfaces/interface[name=*]/routed-vlan/ipv4/state/counters/out-discarded-pkts	(type=counter64)
/interfaces/interface[name=*]/routed-vlan/ipv4/state/counters/out-error-pkts	(type=counter64)
/interfaces/interface[name=*]/routed-vlan/ipv4/state/counters/out-forwarded-octets	(type=counter64)
/interfaces/interface[name=*]/routed-vlan/ipv4/state/counters/out-forwarded-pkts	(type=counter64)
/interfaces/interface[name=*]/routed-vlan/ipv4/state/counters/out-octets	(type=counter64)
/interfaces/interface[name=*]/routed-vlan/ipv4/state/counters/out-pkts	(type=counter64)
/interfaces/interface[name=*]/routed-vlan/ipv4/state/dhcp-client	(type=boolean)
/interfaces/interface[name=*]/routed-vlan/ipv4/state/enabled	(type=boolean)
/interfaces/interface[name=*]/routed-vlan/ipv4/state/mtu	(type=uint16)
/interfaces/interface[name=*]/routed-vlan/ipv4/unnumbered/config/enabled	(type=boolean)
/interfaces/interface[name=*]/routed-vlan/ipv4/unnumbered/interface-ref/config/interface	(type=leafref)
/interfaces/interface[name=*]/routed-vlan/ipv4/unnumbered/interface-ref/config/subinterface	(type=leafref)
/interfaces/interface[name=*]/routed-vlan/ipv4/unnumbered/interface-ref/state/interface	(type=leafref)
/interfaces/interface[name=*]/routed-vlan/ipv4/unnumbered/interface-ref/state/subinterface	(type=leafref)
/interfaces/interface[name=*]/routed-vlan/ipv4/unnumbered/state/enabled	(type=boolean)
/interfaces/interface[name=*]/routed-vlan/ipv6/addresses/address[ip=*]/config/ip	(type=ipv6-address)
/interfaces/interface[name=*]/routed-vlan/ipv6/addresses/address[ip=*]/config/prefix-length	(type=uint8)
/interfaces/interface[name=*]/routed-vlan/ipv6/addresses/address[ip=*]/ip	(type=leafref)
/interfaces/interface[name=*]/routed-vlan/ipv6/addresses/address[ip=*]/state/ip	(type=ipv6-address)
/interfaces/interface[name=*]/routed-vlan/ipv6/addresses/address[ip=*]/state/origin	(type=ip-address-origin)
/interfaces/interface[name=*]/routed-vlan/ipv6/addresses/address[ip=*]/state/prefix-length	(type=uint8)
/interfaces/interface[name=*]/routed-vlan/ipv6/addresses/address[ip=*]/state/status	(type=enumeration)
/interfaces/interface[name=*]/routed-vlan/ipv6/addresses/address[ip=*]/vrrp/vrrp-group[virtual-router-id=*]/config/accept-mode	(type=boolean)
/interfaces/interface[name=*]/routed-vlan/ipv6/addresses/address[ip=*]/vrrp/vrrp-group[virtual-router-id=*]/config/advertisement-interval	(type=uint16)
/interfaces/interface[name=*]/routed-vlan/ipv6/addresses/address[ip=*]/vrrp/vrrp-group[virtual-router-id=*]/config/preempt	(type=boolean)
/interfaces/interface[name=*]/routed-vlan/ipv6/addresses/address[ip=*]/vrrp/vrrp-group[virtual-router-id=*]/config/preempt-delay	(type=uint16)
/interfaces/interface[name=*]/routed-vlan/ipv6/addresses/address[ip=*]/vrrp/vrrp-group[virtual-router-id=*]/config/priority	(type=uint8)
/interfaces/interface[name=*]/routed-vlan/ipv6/addresses/address[ip=*]/vrrp/vrrp-group[virtual-router-id=*]/config/virtual-address	(type=ip-address)
/interfaces/interface[name=*]/routed-vlan/ipv6/addresses/address[ip=*]/vrrp/vrrp-group[virtual-router-id=*]/config/virtual-link-local	(type=ip-address)
/interfaces/interface[name=*]/routed-vlan/ipv6/addresses/address[ip=*]/vrrp/vrrp-group[virtual-router-id=*]/config/virtual-router-id	(type=uint8)
/interfaces/interface[name=*]/routed-vlan/ipv6/addresses/address[ip=*]/vrrp/vrrp-group[virtual-router-id=*]/interface-tracking/config/priority-decrement	(type=uint8)
/interfaces/interface[name=*]/routed-vlan/ipv6/addresses/address[ip=*]/vrrp/vrrp-group[virtual-router-id=*]/interface-tracking/config/track-interface	(type=leafref)
/interfaces/interface[name=*]/routed-vlan/ipv6/addresses/address[ip=*]/vrrp/vrrp-group[virtual-router-id=*]/interface-tracking/state/priority-decrement	(type=uint8)
/interfaces/interface[name=*]/routed-vlan/ipv6/addresses/address[ip=*]/vrrp/vrrp-group[virtual-router-id=*]/interface-tracking/state/track-interface	(type=leafref)
/interfaces/interface[name=*]/routed-vlan/ipv6/addresses/address[ip=*]/vrrp/vrrp-group[virtual-router-id=*]/state/accept-mode	(type=boolean)
/interfaces/interface[name=*]/routed-vlan/ipv6/addresses/address[ip=*]/vrrp/vrrp-group[virtual-router-id=*]/state/advertisement-interval	(type=uint16)
/interfaces/interface[name=*]/routed-vlan/ipv6/addresses/address[ip=*]/vrrp/vrrp-group[virtual-router-id=*]/state/current-priority	(type=uint8)
/interfaces/interface[name=*]/routed-vlan/ipv6/addresses/address[ip=*]/vrrp/vrrp-group[virtual-router-id=*]/state/preempt	(type=boolean)
/interfaces/interface[name=*]/routed-vlan/ipv6/addresses/address[ip=*]/vrrp/vrrp-group[virtual-router-id=*]/state/preempt-delay	(type=uint16)
/interfaces/interface[name=*]/routed-vlan/ipv6/addresses/address[ip=*]/vrrp/vrrp-group[virtual-router-id=*]/state/priority	(type=uint8)
/interfaces/interface[name=*]/routed-vlan/ipv6/addresses/address[ip=*]/vrrp/vrrp-group[virtual-router-id=*]/state/virtual-address	(type=ip-address)
/interfaces/interface[name=*]/routed-vlan/ipv6/addresses/address[ip=*]/vrrp/vrrp-group[virtual-router-id=*]/state/virtual-link-local	(type=ip-address)
/interfaces/interface[name=*]/routed-vlan/ipv6/addresses/address[ip=*]/vrrp/vrrp-group[virtual-router-id=*]/state/virtual-router-id	(type=uint8)
/interfaces/interface[name=*]/routed-vlan/ipv6/addresses/address[ip=*]/vrrp/vrrp-group[virtual-router-id=*]/virtual-router-id	(type=leafref)
/interfaces/interface[name=*]/routed-vlan/ipv6/config/dhcp-client	(type=boolean)
/interfaces/interface[name=*]/routed-vlan/ipv6/config/dup-addr-detect-transmits	(type=uint32)
/interfaces/interface[name=*]/routed-vlan/ipv6/config/enabled	(type=boolean)
/interfaces/interface[name=*]/routed-vlan/ipv6/config/mtu	(type=uint32)
/interfaces/interface[name=*]/routed-vlan/ipv6/neighbors/neighbor[ip=*]/config/ip	(type=ipv6-address)
/interfaces/interface[name=*]/routed-vlan/ipv6/neighbors/neighbor[ip=*]/config/link-layer-address	(type=phys-address)
/interfaces/interface[name=*]/routed-vlan/ipv6/neighbors/neighbor[ip=*]/ip	(type=leafref)
/interfaces/interface[name=*]/routed-vlan/ipv6/neighbors/neighbor[ip=*]/state/ip	(type=ipv6-address)
/interfaces/interface[name=*]/routed-vlan/ipv6/neighbors/neighbor[ip=*]/state/is-router	(type=boolean)
/interfaces/interface[name=*]/routed-vlan/ipv6/neighbors/neighbor[ip=*]/state/link-layer-address	(type=phys-address)
/interfaces/interface[name=*]/routed-vlan/ipv6/neighbors/neighbor[ip=*]/state/neighbor-state	(type=enumeration)
/interfaces/interface[name=*]/routed-vlan/ipv6/neighbors/neighbor[ip=*]/state/origin	(type=neighbor-origin)
/interfaces/interface[name=*]/routed-vlan/ipv6/router-advertisement/config/interval	(type=uint32)
/interfaces/interface[name=*]/routed-vlan/ipv6/router-advertisement/config/lifetime	(type=uint32)
/interfaces/interface[name=*]/routed-vlan/ipv6/router-advertisement/config/suppress	(type=boolean)
/interfaces/interface[name=*]/routed-vlan/ipv6/router-advertisement/state/interval	(type=uint32)
/interfaces/interface[name=*]/routed-vlan/ipv6/router-advertisement/state/lifetime	(type=uint32)
/interfaces/interface[name=*]/routed-vlan/ipv6/router-advertisement/state/suppress	(type=boolean)
/interfaces/interface[name=*]/routed-vlan/ipv6/state/counters/in-discarded-pkts	(type=counter64)
/interfaces/interface[name=*]/routed-vlan/ipv6/state/counters/in-error-pkts	(type=counter64)
/interfaces/interface[name=*]/routed-vlan/ipv6/state/counters/in-forwarded-octets	(type=counter64)
/interfaces/interface[name=*]/routed-vlan/ipv6/state/counters/in-forwarded-pkts	(type=counter64)
/interfaces/interface[name=*]/routed-vlan/ipv6/state/counters/in-octets	(type=counter64)
/interfaces/interface[name=*]/routed-vlan/ipv6/state/counters/in-pkts	(type=counter64)
/interfaces/interface[name=*]/routed-vlan/ipv6/state/counters/out-discarded-pkts	(type=counter64)
/interfaces/interface[name=*]/routed-vlan/ipv6/state/counters/out-error-pkts	(type=counter64)
/interfaces/interface[name=*]/routed-vlan/ipv6/state/counters/out-forwarded-octets	(type=counter64)
/interfaces/interface[name=*]/routed-vlan/ipv6/state/counters/out-forwarded-pkts	(type=counter64)
/interfaces/interface[name=*]/routed-vlan/ipv6/state/counters/out-octets	(type=counter64)
/interfaces/interface[name=*]/routed-vlan/ipv6/state/counters/out-pkts	(type=counter64)
/interfaces/interface[name=*]/routed-vlan/ipv6/state/dhcp-client	(type=boolean)
/interfaces/interface[name=*]/routed-vlan/ipv6/state/dup-addr-detect-transmits	(type=uint32)
/interfaces/interface[name=*]/routed-vlan/ipv6/state/enabled	(type=boolean)
/interfaces/interface[name=*]/routed-vlan/ipv6/state/mtu	(type=uint32)
/interfaces/interface[name=*]/routed-vlan/ipv6/unnumbered/config/enabled	(type=boolean)
/interfaces/interface[name=*]/routed-vlan/ipv6/unnumbered/interface-ref/config/interface	(type=leafref)
/interfaces/interface[name=*]/routed-vlan/ipv6/unnumbered/interface-ref/config/subinterface	(type=leafref)
/interfaces/interface[name=*]/routed-vlan/ipv6/unnumbered/interface-ref/state/interface	(type=leafref)
/interfaces/interface[name=*]/routed-vlan/ipv6/unnumbered/interface-ref/state/subinterface	(type=leafref)
/interfaces/interface[name=*]/routed-vlan/ipv6/unnumbered/state/enabled	(type=boolean)
/interfaces/interface[name=*]/routed-vlan/state/vlan	(type=union)
/interfaces/interface[name=*]/state/admin-status	(type=enumeration)
/interfaces/interface[name=*]/state/counters/carrier-transitions	(type=counter64)
/interfaces/interface[name=*]/state/counters/in-broadcast-pkts	(type=counter64)
/interfaces/interface[name=*]/state/counters/in-discards	(type=counter64)
/interfaces/interface[name=*]/state/counters/in-errors	(type=counter64)
/interfaces/interface[name=*]/state/counters/in-fcs-errors	(type=counter64)
/interfaces/interface[name=*]/state/counters/in-multicast-pkts	(type=counter64)
/interfaces/interface[name=*]/state/counters/in-octets	(type=counter64)
/interfaces/interface[name=*]/state/counters/in-pkts	(type=counter64)
/interfaces/interface[name=*]/state/counters/in-unicast-pkts	(type=counter64)
/interfaces/interface[name=*]/state/counters/in-unknown-protos	(type=counter64)
/interfaces/interface[name=*]/state/counters/last-clear	(type=timeticks64)
/interfaces/interface[name=*]/state/counters/out-broadcast-pkts	(type=counter64)
/interfaces/interface[name=*]/state/counters/out-discards	(type=counter64)
/interfaces/interface[name=*]/state/counters/out-errors	(type=counter64)
/interfaces/interface[name=*]/state/counters/out-multicast-pkts	(type=counter64)
/interfaces/interface[name=*]/state/counters/out-octets	(type=counter64)
/interfaces/interface[name=*]/state/counters/out-unicast-pkts	(type=counter64)
/interfaces/interface[name=*]/state/cpu	(type=boolean)
/interfaces/interface[name=*]/state/description	(type=string)
/interfaces/interface[name=*]/state/enabled	(type=boolean)
/interfaces/interface[name=*]/state/ifindex	(type=uint32)
/interfaces/interface[name=*]/state/last-change	(type=timeticks64)
/interfaces/interface[name=*]/state/logical	(type=boolean)
/interfaces/interface[name=*]/state/loopback-mode	(type=boolean)
/interfaces/interface[name=*]/state/management	(type=boolean)
/interfaces/interface[name=*]/state/mtu	(type=uint16)
/interfaces/interface[name=*]/state/name	(type=string)
/interfaces/interface[name=*]/state/oper-status	(type=enumeration)
/interfaces/interface[name=*]/state/tpid	(type=identityref)
/interfaces/interface[name=*]/subinterfaces/subinterface[index=*]/config/description	(type=string)
/interfaces/interface[name=*]/subinterfaces/subinterface[index=*]/config/enabled	(type=boolean)
/interfaces/interface[name=*]/subinterfaces/subinterface[index=*]/config/index	(type=uint32)
/interfaces/interface[name=*]/subinterfaces/subinterface[index=*]/index	(type=leafref)
/interfaces/interface[name=*]/subinterfaces/subinterface[index=*]/ipv4/addresses/address[ip=*]/config/ip	(type=ipv4-address)
/interfaces/interface[name=*]/subinterfaces/subinterface[index=*]/ipv4/addresses/address[ip=*]/config/prefix-length	(type=uint8)
/interfaces/interface[name=*]/subinterfaces/subinterface[index=*]/ipv4/addresses/address[ip=*]/ip	(type=leafref)
/interfaces/interface[name=*]/subinterfaces/subinterface[index=*]/ipv4/addresses/address[ip=*]/state/ip	(type=ipv4-address)
/interfaces/interface[name=*]/subinterfaces/subinterface[index=*]/ipv4/addresses/address[ip=*]/state/origin	(type=ip-address-origin)
/interfaces/interface[name=*]/subinterfaces/subinterface[index=*]/ipv4/addresses/address[ip=*]/state/prefix-length	(type=uint8)
/interfaces/interface[name=*]/subinterfaces/subinterface[index=*]/ipv4/config/dhcp-client	(type=boolean)
/interfaces/interface[name=*]/subinterfaces/subinterface[index=*]/ipv4/config/enabled	(type=boolean)
/interfaces/interface[name=*]/subinterfaces/subinterface[index=*]/ipv4/config/mtu	(type=uint16)
/interfaces/interface[name=*]/subinterfaces/subinterface[index=*]/ipv4/neighbors/neighbor[ip=*]/config/ip	(type=ipv4-address)
/interfaces/interface[name=*]/subinterfaces/subinterface[index=*]/ipv4/neighbors/neighbor[ip=*]/config/link-layer-address	(type=phys-address)
/interfaces/interface[name=*]/subinterfaces/subinterface[index=*]/ipv4/neighbors/neighbor[ip=*]/ip	(type=leafref)
/interfaces/interface[name=*]/subinterfaces/subinterface[index=*]/ipv4/neighbors/neighbor[ip=*]/state/ip	(type=ipv4-address)
/interfaces/interface[name=*]/subinterfaces/subinterface[index=*]/ipv4/neighbors/neighbor[ip=*]/state/link-layer-address	(type=phys-address)
/interfaces/interface[name=*]/subinterfaces/subinterface[index=*]/ipv4/neighbors/neighbor[ip=*]/state/origin	(type=neighbor-origin)
/interfaces/interface[name=*]/subinterfaces/subinterface[index=*]/ipv4/proxy-arp/config/mode	(type=enumeration)
/interfaces/interface[name=*]/subinterfaces/subinterface[index=*]/ipv4/proxy-arp/state/mode	(type=enumeration)
/interfaces/interface[name=*]/subinterfaces/subinterface[index=*]/ipv4/state/counters/in-discarded-pkts	(type=counter64)
/interfaces/interface[name=*]/subinterfaces/subinterface[index=*]/ipv4/state/counters/in-error-pkts	(type=counter64)
/interfaces/interface[name=*]/subinterfaces/subinterface[index=*]/ipv4/state/counters/in-forwarded-octets	(type=counter64)
/interfaces/interface[name=*]/subinterfaces/subinterface[index=*]/ipv4/state/counters/in-forwarded-pkts	(type=counter64)
/interfaces/interface[name=*]/subinterfaces/subinterface[index=*]/ipv4/state/counters/in-octets	(type=counter64)
/interfaces/interface[name=*]/subinterfaces/subinterface[index=*]/ipv4/state/counters/in-pkts	(type=counter64)
/interfaces/interface[name=*]/subinterfaces/subinterface[index=*]/ipv4/state/counters/out-discarded-pkts	(type=counter64)
/interfaces/interface[name=*]/subinterfaces/subinterface[index=*]/ipv4/state/counters/out-error-pkts	(type=counter64)
/interfaces/interface[name=*]/subinterfaces/subinterface[index=*]/ipv4/state/counters/out-forwarded-octets	(type=counter64)
/interfaces/interface[name=*]/subinterfaces/subinterface[index=*]/ipv4/state/counters/out-forwarded-pkts	(type=counter64)
/interfaces/interface[name=*]/subinterfaces/subinterface[index=*]/ipv4/state/counters/out-octets	(type=counter64)
/interfaces/interface[name=*]/subinterfaces/subinterface[index=*]/ipv4/state/counters/out-pkts	(type=counter64)
/interfaces/interface[name=*]/subinterfaces/subinterface[index=*]/ipv4/state/dhcp-client	(type=boolean)
/interfaces/interface[name=*]/subinterfaces/subinterface[index=*]/ipv4/state/enabled	(type=boolean)
/interfaces/interface[name=*]/subinterfaces/subinterface[index=*]/ipv4/state/mtu	(type=uint16)
/interfaces/interface[name=*]/subinterfaces/subinterface[index=*]/ipv4/unnumbered/config/enabled	(type=boolean)
/interfaces/interface[name=*]/subinterfaces/subinterface[index=*]/ipv4/unnumbered/interface-ref/config/interface	(type=leafref)
/interfaces/interface[name=*]/subinterfaces/subinterface[index=*]/ipv4/unnumbered/interface-ref/config/subinterface	(type=leafref)
/interfaces/interface[name=*]/subinterfaces/subinterface[index=*]/ipv4/unnumbered/interface-ref/state/interface	(type=leafref)
/interfaces/interface[name=*]/subinterfaces/subinterface[index=*]/ipv4/unnumbered/interface-ref/state/subinterface	(type=leafref)
/interfaces/interface[name=*]/subinterfaces/subinterface[index=*]/ipv4/unnumbered/state/enabled	(type=boolean)
/interfaces/interface[name=*]/subinterfaces/subinterface[index=*]/ipv6/addresses/address[ip=*]/config/ip	(type=ipv6-address)
/interfaces/interface[name=*]/subinterfaces/subinterface[index=*]/ipv6/addresses/address[ip=*]/config/prefix-length	(type=uint8)
/interfaces/interface[name=*]/subinterfaces/subinterface[index=*]/ipv6/addresses/address[ip=*]/ip	(type=leafref)
/interfaces/interface[name=*]/subinterfaces/subinterface[index=*]/ipv6/addresses/address[ip=*]/state/ip	(type=ipv6-address)
/interfaces/interface[name=*]/subinterfaces/subinterface[index=*]/ipv6/addresses/address[ip=*]/state/origin	(type=ip-address-origin)
/interfaces/interface[name=*]/subinterfaces/subinterface[index=*]/ipv6/addresses/address[ip=*]/state/prefix-length	(type=uint8)
/interfaces/interface[name=*]/subinterfaces/subinterface[index=*]/ipv6/addresses/address[ip=*]/state/status	(type=enumeration)
/interfaces/interface[name=*]/subinterfaces/subinterface[index=*]/ipv6/config/dhcp-client	(type=boolean)
/interfaces/interface[name=*]/subinterfaces/subinterface[index=*]/ipv6/config/dup-addr-detect-transmits	(type=uint32)
/interfaces/interface[name=*]/subinterfaces/subinterface[index=*]/ipv6/config/enabled	(type=boolean)
/interfaces/interface[name=*]/subinterfaces/subinterface[index=*]/ipv6/config/mtu	(type=uint32)
/interfaces/interface[name=*]/subinterfaces/subinterface[index=*]/ipv6/neighbors/neighbor[ip=*]/config/ip	(type=ipv6-address)
/interfaces/interface[name=*]/subinterfaces/subinterface[index=*]/ipv6/neighbors/neighbor[ip=*]/config/link-layer-address	(type=phys-address)
/interfaces/interface[name=*]/subinterfaces/subinterface[index=*]/ipv6/neighbors/neighbor[ip=*]/ip	(type=leafref)
/interfaces/interface[name=*]/subinterfaces/subinterface[index=*]/ipv6/neighbors/neighbor[ip=*]/state/ip	(type=ipv6-address)
/interfaces/interface[name=*]/subinterfaces/subinterface[index=*]/ipv6/neighbors/neighbor[ip=*]/state/is-router	(type=boolean)
/interfaces/interface[name=*]/subinterfaces/subinterface[index=*]/ipv6/neighbors/neighbor[ip=*]/state/link-layer-address	(type=phys-address)
/interfaces/interface[name=*]/subinterfaces/subinterface[index=*]/ipv6/neighbors/neighbor[ip=*]/state/neighbor-state	(type=enumeration)
/interfaces/interface[name=*]/subinterfaces/subinterface[index=*]/ipv6/neighbors/neighbor[ip=*]/state/origin	(type=neighbor-origin)
/interfaces/interface[name=*]/subinterfaces/subinterface[index=*]/ipv6/router-advertisement/config/interval	(type=uint32)
/interfaces/interface[name=*]/subinterfaces/subinterface[index=*]/ipv6/router-advertisement/config/lifetime	(type=uint32)
/interfaces/interface[name=*]/subinterfaces/subinterface[index=*]/ipv6/router-advertisement/config/suppress	(type=boolean)
/interfaces/interface[name=*]/subinterfaces/subinterface[index=*]/ipv6/router-advertisement/state/interval	(type=uint32)
/interfaces/interface[name=*]/subinterfaces/subinterface[index=*]/ipv6/router-advertisement/state/lifetime	(type=uint32)
/interfaces/interface[name=*]/subinterfaces/subinterface[index=*]/ipv6/router-advertisement/state/suppress	(type=boolean)
/interfaces/interface[name=*]/subinterfaces/subinterface[index=*]/ipv6/state/counters/in-discarded-pkts	(type=counter64)
/interfaces/interface[name=*]/subinterfaces/subinterface[index=*]/ipv6/state/counters/in-error-pkts	(type=counter64)
/interfaces/interface[name=*]/subinterfaces/subinterface[index=*]/ipv6/state/counters/in-forwarded-octets	(type=counter64)
/interfaces/interface[name=*]/subinterfaces/subinterface[index=*]/ipv6/state/counters/in-forwarded-pkts	(type=counter64)
/interfaces/interface[name=*]/subinterfaces/subinterface[index=*]/ipv6/state/counters/in-octets	(type=counter64)
/interfaces/interface[name=*]/subinterfaces/subinterface[index=*]/ipv6/state/counters/in-pkts	(type=counter64)
/interfaces/interface[name=*]/subinterfaces/subinterface[index=*]/ipv6/state/counters/out-discarded-pkts	(type=counter64)
/interfaces/interface[name=*]/subinterfaces/subinterface[index=*]/ipv6/state/counters/out-error-pkts	(type=counter64)
/interfaces/interface[name=*]/subinterfaces/subinterface[index=*]/ipv6/state/counters/out-forwarded-octets	(type=counter64)
/interfaces/interface[name=*]/subinterfaces/subinterface[index=*]/ipv6/state/counters/out-forwarded-pkts	(type=counter64)
/interfaces/interface[name=*]/subinterfaces/subinterface[index=*]/ipv6/state/counters/out-octets	(type=counter64)
/interfaces/interface[name=*]/subinterfaces/subinterface[index=*]/ipv6/state/counters/out-pkts	(type=counter64)
/interfaces/interface[name=*]/subinterfaces/subinterface[index=*]/ipv6/state/dhcp-client	(type=boolean)
/interfaces/interface[name=*]/subinterfaces/subinterface[index=*]/ipv6/state/dup-addr-detect-transmits	(type=uint32)
/interfaces/interface[name=*]/subinterfaces/subinterface[index=*]/ipv6/state/enabled	(type=boolean)
/interfaces/interface[name=*]/subinterfaces/subinterface[index=*]/ipv6/state/mtu	(type=uint32)
/interfaces/interface[name=*]/subinterfaces/subinterface[index=*]/ipv6/unnumbered/config/enabled	(type=boolean)
/interfaces/interface[name=*]/subinterfaces/subinterface[index=*]/ipv6/unnumbered/interface-ref/config/interface	(type=leafref)
/interfaces/interface[name=*]/subinterfaces/subinterface[index=*]/ipv6/unnumbered/interface-ref/config/subinterface	(type=leafref)
/interfaces/interface[name=*]/subinterfaces/subinterface[index=*]/ipv6/unnumbered/interface-ref/state/interface	(type=leafref)
/interfaces/interface[name=*]/subinterfaces/subinterface[index=*]/ipv6/unnumbered/interface-ref/state/subinterface	(type=leafref)
/interfaces/interface[name=*]/subinterfaces/subinterface[index=*]/ipv6/unnumbered/state/enabled	(type=boolean)
/interfaces/interface[name=*]/subinterfaces/subinterface[index=*]/state/admin-status	(type=enumeration)
/interfaces/interface[name=*]/subinterfaces/subinterface[index=*]/state/counters/carrier-transitions	(type=counter64)
/interfaces/interface[name=*]/subinterfaces/subinterface[index=*]/state/counters/in-broadcast-pkts	(type=counter64)
/interfaces/interface[name=*]/subinterfaces/subinterface[index=*]/state/counters/in-discards	(type=counter64)
/interfaces/interface[name=*]/subinterfaces/subinterface[index=*]/state/counters/in-errors	(type=counter64)
/interfaces/interface[name=*]/subinterfaces/subinterface[index=*]/state/counters/in-fcs-errors	(type=counter64)
/interfaces/interface[name=*]/subinterfaces/subinterface[index=*]/state/counters/in-multicast-pkts	(type=counter64)
/interfaces/interface[name=*]/subinterfaces/subinterface[index=*]/state/counters/in-octets	(type=counter64)
/interfaces/interface[name=*]/subinterfaces/subinterface[index=*]/state/counters/in-pkts	(type=counter64)
/interfaces/interface[name=*]/subinterfaces/subinterface[index=*]/state/counters/in-unicast-pkts	(type=counter64)
/interfaces/interface[name=*]/subinterfaces/subinterface[index=*]/state/counters/in-unknown-protos	(type=counter64)
/interfaces/interface[name=*]/subinterfaces/subinterface[index=*]/state/counters/last-clear	(type=timeticks64)
/interfaces/interface[name=*]/subinterfaces/subinterface[index=*]/state/counters/out-broadcast-pkts	(type=counter64)
/interfaces/interface[name=*]/subinterfaces/subinterface[index=*]/state/counters/out-discards	(type=counter64)
/interfaces/interface[name=*]/subinterfaces/subinterface[index=*]/state/counters/out-errors	(type=counter64)
/interfaces/interface[name=*]/subinterfaces/subinterface[index=*]/state/counters/out-multicast-pkts	(type=counter64)
/interfaces/interface[name=*]/subinterfaces/subinterface[index=*]/state/counters/out-octets	(type=counter64)
/interfaces/interface[name=*]/subinterfaces/subinterface[index=*]/state/counters/out-pkts	(type=counter64)
/interfaces/interface[name=*]/subinterfaces/subinterface[index=*]/state/counters/out-unicast-pkts	(type=counter64)
/interfaces/interface[name=*]/subinterfaces/subinterface[index=*]/state/cpu	(type=boolean)
/interfaces/interface[name=*]/subinterfaces/subinterface[index=*]/state/description	(type=string)
/interfaces/interface[name=*]/subinterfaces/subinterface[index=*]/state/enabled	(type=boolean)
/interfaces/interface[name=*]/subinterfaces/subinterface[index=*]/state/ifindex	(type=uint32)
/interfaces/interface[name=*]/subinterfaces/subinterface[index=*]/state/index	(type=uint32)
/interfaces/interface[name=*]/subinterfaces/subinterface[index=*]/state/last-change	(type=timeticks64)
/interfaces/interface[name=*]/subinterfaces/subinterface[index=*]/state/logical	(type=boolean)
/interfaces/interface[name=*]/subinterfaces/subinterface[index=*]/state/management	(type=boolean)
/interfaces/interface[name=*]/subinterfaces/subinterface[index=*]/state/name	(type=string)
/interfaces/interface[name=*]/subinterfaces/subinterface[index=*]/state/oper-status	(type=enumeration)
/interfaces/interface[name=*]/subinterfaces/subinterface[index=*]/vlan/config/vlan-id	(type=union)
/interfaces/interface[name=*]/subinterfaces/subinterface[index=*]/vlan/egress-mapping/config/tpid	(type=identityref)
/interfaces/interface[name=*]/subinterfaces/subinterface[index=*]/vlan/egress-mapping/config/vlan-id	(type=vlan-id)
/interfaces/interface[name=*]/subinterfaces/subinterface[index=*]/vlan/egress-mapping/config/vlan-stack-action	(type=vlan-stack-action)
/interfaces/interface[name=*]/subinterfaces/subinterface[index=*]/vlan/egress-mapping/state/tpid	(type=identityref)
/interfaces/interface[name=*]/subinterfaces/subinterface[index=*]/vlan/egress-mapping/state/vlan-id	(type=vlan-id)
/interfaces/interface[name=*]/subinterfaces/subinterface[index=*]/vlan/egress-mapping/state/vlan-stack-action	(type=vlan-stack-action)
/interfaces/interface[name=*]/subinterfaces/subinterface[index=*]/vlan/ingress-mapping/config/tpid	(type=identityref)
/interfaces/interface[name=*]/subinterfaces/subinterface[index=*]/vlan/ingress-mapping/config/vlan-id	(type=vlan-id)
/interfaces/interface[name=*]/subinterfaces/subinterface[index=*]/vlan/ingress-mapping/config/vlan-stack-action	(type=vlan-stack-action)
/interfaces/interface[name=*]/subinterfaces/subinterface[index=*]/vlan/ingress-mapping/state/tpid	(type=identityref)
/interfaces/interface[name=*]/subinterfaces/subinterface[index=*]/vlan/ingress-mapping/state/vlan-id	(type=vlan-id)
/interfaces/interface[name=*]/subinterfaces/subinterface[index=*]/vlan/ingress-mapping/state/vlan-stack-action	(type=vlan-stack-action)
/interfaces/interface[name=*]/subinterfaces/subinterface[index=*]/vlan/match/double-tagged-inner-list/config/inner-vlan-ids	(type=vlan-id)
/interfaces/interface[name=*]/subinterfaces/subinterface[index=*]/vlan/match/double-tagged-inner-list/config/outer-vlan-id	(type=vlan-id)
/interfaces/interface[name=*]/subinterfaces/subinterface[index=*]/vlan/match/double-tagged-inner-list/state/inner-vlan-ids	(type=vlan-id)
/interfaces/interface[name=*]/subinterfaces/subinterface[index=*]/vlan/match/double-tagged-inner-list/state/outer-vlan-id	(type=vlan-id)
/interfaces/interface[name=*]/subinterfaces/subinterface[index=*]/vlan/match/double-tagged-inner-outer-range/config/inner-high-vlan-id	(type=vlan-id)
/interfaces/interface[name=*]/subinterfaces/subinterface[index=*]/vlan/match/double-tagged-inner-outer-range/config/inner-low-vlan-id	(type=vlan-id)
/interfaces/interface[name=*]/subinterfaces/subinterface[index=*]/vlan/match/double-tagged-inner-outer-range/config/outer-high-vlan-id	(type=vlan-id)
/interfaces/interface[name=*]/subinterfaces/subinterface[index=*]/vlan/match/double-tagged-inner-outer-range/config/outer-low-vlan-id	(type=vlan-id)
/interfaces/interface[name=*]/subinterfaces/subinterface[index=*]/vlan/match/double-tagged-inner-outer-range/state/inner-high-vlan-id	(type=vlan-id)
/interfaces/interface[name=*]/subinterfaces/subinterface[index=*]/vlan/match/double-tagged-inner-outer-range/state/inner-low-vlan-id	(type=vlan-id)
/interfaces/interface[name=*]/subinterfaces/subinterface[index=*]/vlan/match/double-tagged-inner-outer-range/state/outer-high-vlan-id	(type=vlan-id)
/interfaces/interface[name=*]/subinterfaces/subinterface[index=*]/vlan/match/double-tagged-inner-outer-range/state/outer-low-vlan-id	(type=vlan-id)
/interfaces/interface[name=*]/subinterfaces/subinterface[index=*]/vlan/match/double-tagged-inner-range/config/inner-high-vlan-id	(type=vlan-id)
/interfaces/interface[name=*]/subinterfaces/subinterface[index=*]/vlan/match/double-tagged-inner-range/config/inner-low-vlan-id	(type=vlan-id)
/interfaces/interface[name=*]/subinterfaces/subinterface[index=*]/vlan/match/double-tagged-inner-range/config/outer-vlan-id	(type=vlan-id)
/interfaces/interface[name=*]/subinterfaces/subinterface[index=*]/vlan/match/double-tagged-inner-range/state/inner-high-vlan-id	(type=vlan-id)
/interfaces/interface[name=*]/subinterfaces/subinterface[index=*]/vlan/match/double-tagged-inner-range/state/inner-low-vlan-id	(type=vlan-id)
/interfaces/interface[name=*]/subinterfaces/subinterface[index=*]/vlan/match/double-tagged-inner-range/state/outer-vlan-id	(type=vlan-id)
/interfaces/interface[name=*]/subinterfaces/subinterface[index=*]/vlan/match/double-tagged-outer-list/config/inner-vlan-id	(type=vlan-id)
/interfaces/interface[name=*]/subinterfaces/subinterface[index=*]/vlan/match/double-tagged-outer-list/config/outer-vlan-ids	(type=vlan-id)
/interfaces/interface[name=*]/subinterfaces/subinterface[index=*]/vlan/match/double-tagged-outer-list/state/inner-vlan-id	(type=vlan-id)
/interfaces/interface[name=*]/subinterfaces/subinterface[index=*]/vlan/match/double-tagged-outer-list/state/outer-vlan-ids	(type=vlan-id)
/interfaces/interface[name=*]/subinterfaces/subinterface[index=*]/vlan/match/double-tagged-outer-range/config/inner-vlan-id	(type=vlan-id)
/interfaces/interface[name=*]/subinterfaces/subinterface[index=*]/vlan/match/double-tagged-outer-range/config/outer-high-vlan-id	(type=vlan-id)
/interfaces/interface[name=*]/subinterfaces/subinterface[index=*]/vlan/match/double-tagged-outer-range/config/outer-low-vlan-id	(type=vlan-id)
/interfaces/interface[name=*]/subinterfaces/subinterface[index=*]/vlan/match/double-tagged-outer-range/state/inner-vlan-id	(type=vlan-id)
/interfaces/interface[name=*]/subinterfaces/subinterface[index=*]/vlan/match/double-tagged-outer-range/state/outer-high-vlan-id	(type=vlan-id)
/interfaces/interface[name=*]/subinterfaces/subinterface[index=*]/vlan/match/double-tagged-outer-range/state/outer-low-vlan-id	(type=vlan-id)
/interfaces/interface[name=*]/subinterfaces/subinterface[index=*]/vlan/match/double-tagged/config/inner-vlan-id	(type=vlan-id)
/interfaces/interface[name=*]/subinterfaces/subinterface[index=*]/vlan/match/double-tagged/config/outer-vlan-id	(type=vlan-id)
/interfaces/interface[name=*]/subinterfaces/subinterface[index=*]/vlan/match/double-tagged/state/inner-vlan-id	(type=vlan-id)
/interfaces/interface[name=*]/subinterfaces/subinterface[index=*]/vlan/match/double-tagged/state/outer-vlan-id	(type=vlan-id)
/interfaces/interface[name=*]/subinterfaces/subinterface[index=*]/vlan/match/single-tagged-list/config/vlan-ids	(type=vlan-id)
/interfaces/interface[name=*]/subinterfaces/subinterface[index=*]/vlan/match/single-tagged-list/state/vlan-ids	(type=vlan-id)
/interfaces/interface[name=*]/subinterfaces/subinterface[index=*]/vlan/match/single-tagged-range/config/high-vlan-id	(type=vlan-id)
/interfaces/interface[name=*]/subinterfaces/subinterface[index=*]/vlan/match/single-tagged-range/config/low-vlan-id	(type=vlan-id)
/interfaces/interface[name=*]/subinterfaces/subinterface[index=*]/vlan/match/single-tagged-range/state/high-vlan-id	(type=vlan-id)
/interfaces/interface[name=*]/subinterfaces/subinterface[index=*]/vlan/match/single-tagged-range/state/low-vlan-id	(type=vlan-id)
/interfaces/interface[name=*]/subinterfaces/subinterface[index=*]/vlan/match/single-tagged/config/vlan-id	(type=vlan-id)
/interfaces/interface[name=*]/subinterfaces/subinterface[index=*]/vlan/match/single-tagged/state/vlan-id	(type=vlan-id)
/interfaces/interface[name=*]/subinterfaces/subinterface[index=*]/vlan/state/vlan-id	(type=union)
/interfaces/interface[name=*]/type	(type=identityref)
/interfaces/interface[name=*]/state/counters/out-pkts	(type=counter64)
